1111111111111111111111111111
1222222222222112222222222221
1211112111112112111112111121
1311112111112112111112111131
1211112111112112111112111121
1222222222222222222222222221
1211112112111111112112111121
1222222112222112222112222221
1111112111112112111112111111
1111110111110000111110111111
1111110110000000001110111111
1111110110111441101110111111
1111110110100000101110111111
0000000110100000101110000000
1111110110100000101110111111
1111110110111111101110111111
1111110110000000001110111111
1111110110111111101110111111
1111110111110000111110111111
1111112111112112111112111111
1222222222222112222222222221
1211112111112112111112111121
1322112111112112111112112231
1112112222222222222222112111
1112112112111111112112112111
1222212112222112222112122221
1211111111112112111111111121
1211111111112112111111111121
1222222222222222222222222221
1211112111112112111112111121
1111111111111111111111111111